127 126 126 128 126 128 127 127 126 127 128 126 128 127 126 126 126 128 127 128 126 127 128 126 127 127 126 126 126 126 127 126 126 126 127 126 128 127 128 127 128 127 127 127 127 126 127 127 128 126 
126 125 125 125 126 126 126 125 125 125 125 125 125 125 125 125 125 125 125 125 125 125 125 125 125 125 125 125 125 125 125 125 125 126 128 127 127 127 127 127 127 127 127 127 127 128 128 127 128 126 
128 125 166 125 128 126 125 125 125 125 125 125 125 125 125 125 125 125 125 125 125 125 125 125 125 125 125 125 125 125 125 125 125 125 126 127 127 127 127 127 128 127 127 127 127 127 127 127 126 126 
127 125 125 125 125 125 125 125 125 125 125 125 125 125 125 125 125 125 125 125 125 125 125 125 125 125 125 125 125 125 125 125 125 125 126 127 128 128 126 127 126 126 126 126 128 128 127 127 126 126 
126 125 125 125 125 125 125 125 125 125 125 125 125 125 125 125 125 125 125 125 125 125 125 125 125 125 125 125 125 125 125 125 125 125 126 127 127 126 125 125 125 125 125 126 126 127 128 127 127 128 
128 127 128 126 126 125 125 125 125 125 125 125 125 125 125 125 125 125 125 125 125 125 125 125 125 125 125 125 125 125 125 125 125 125 128 128 127 126 125 125 125 125 125 125 127 126 128 128 127 128 
128 128 127 126 126 125 125 125 125 125 125 125 125 125 125 125 125 125 125 125 125 125 125 125 125 125 125 125 125 125 125 125 125 125 128 128 127 128 125 126 126 126 125 125 126 128 128 128 128 128 
128 128 128 128 128 125 125 125 125 125 125 125 125 125 125 125 125 125 125 125 125 125 125 125 125 125 125 125 125 125 125 125 125 125 128 128 128 126 125 126 127 128 126 125 125 127 128 128 128 128 
126 127 127 128 126 125 125 125 125 125 125 125 125 125 125 125 125 125 125 125 125 125 125 125 125 125 125 125 125 125 125 125 125 125 126 127 128 126 125 126 128 128 127 125 125 128 128 128 128 128 
126 127 128 128 128 126 128 128 126 125 125 125 125 125 125 125 125 125 125 125 125 125 125 125 125 125 125 125 125 125 125 125 125 125 128 128 126 125 125 126 128 127 127 125 125 128 128 128 128 128 
126 127 128 128 128 128 126 127 126 125 125 125 125 125 125 125 125 125 125 125 125 125 125 125 125 125 125 125 125 125 125 125 125 128 128 125 125 125 125 126 128 128 127 125 125 126 126 126 127 128 
127 127 127 128 128 127 128 127 127 128 128 128 128 126 128 126 128 126 126 125 126 128 128 128 128 128 128 128 126 128 126 126 128 128 126 125 126 127 128 127 128 127 127 125 125 125 125 126 128 126 
128 128 128 127 128 128 128 128 128 126 126 128 128 128 128 128 126 126 126 125 126 128 128 128 127 128 128 128 126 126 128 126 128 126 126 125 127 128 127 128 126 126 126 125 125 125 125 126 128 127 
128 128 128 128 128 128 128 128 128 128 126 128 126 126 126 125 125 125 125 125 125 128 128 128 127 128 127 128 125 125 125 125 125 125 125 125 126 128 126 125 125 125 125 125 125 125 125 125 128 128 
128 128 128 128 126 127 126 128 128 128 128 127 128 125 125 125 126 126 125 125 125 127 127 128 128 128 128 126 125 126 126 128 128 128 128 127 127 128 126 125 126 126 126 125 125 125 125 125 128 128 
126 128 128 126 127 127 127 127 128 128 128 128 128 126 126 126 126 126 126 125 128 127 127 128 128 128 126 125 125 125 126 128 128 128 127 127 126 125 125 125 128 128 128 126 125 125 125 126 127 128 
126 128 128 128 128 128 128 127 126 128 128 128 128 128 126 128 128 127 128 125 126 126 126 127 126 128 126 125 125 125 126 128 128 128 127 125 125 125 125 125 128 128 128 126 126 125 126 127 127 128 
128 128 126 126 125 125 126 126 126 128 127 127 127 128 128 128 127 127 126 125 125 125 125 125 125 125 125 125 125 125 126 128 128 128 125 125 125 125 126 126 126 128 128 128 126 125 127 127 128 128 
128 128 127 126 125 125 125 125 125 126 128 128 127 128 127 128 127 127 126 125 128 128 127 128 127 126 126 125 125 125 126 128 128 128 125 128 127 126 128 128 128 128 128 128 126 125 127 127 128 128 
126 127 127 128 125 125 125 125 125 128 128 127 128 127 128 127 127 128 126 125 126 127 127 127 127 127 127 126 126 128 127 128 128 126 125 128 127 128 128 127 127 127 128 126 126 125 127 128 128 128 
126 127 127 126 125 125 125 125 125 128 126 127 126 126 126 127 128 126 126 125 126 126 126 128 127 128 127 127 128 128 126 126 126 126 125 126 128 127 128 128 128 128 128 128 126 125 126 128 127 128 
126 128 127 126 128 126 125 126 126 128 125 125 125 125 125 125 125 125 125 125 125 125 125 125 128 128 128 127 127 126 125 125 125 125 125 126 126 127 128 126 127 128 127 128 126 125 127 128 128 128 
126 127 127 127 127 126 125 128 128 128 125 125 125 125 125 125 125 125 125 125 125 125 125 125 125 128 128 127 127 126 126 125 125 125 125 125 126 127 128 126 127 127 126 126 126 125 126 127 127 128 
126 127 128 127 128 128 125 126 126 125 125 125 125 125 125 125 125 125 125 125 125 125 125 125 125 128 127 128 128 128 126 125 125 125 125 125 127 127 128 127 128 126 126 126 126 125 126 127 126 126 
126 126 128 127 127 128 125 125 125 125 125 125 125 125 125 125 125 125 125 125 125 125 125 125 125 128 127 128 128 128 126 126 126 126 128 126 127 128 128 126 126 125 125 125 125 125 125 127 126 128 
126 128 127 128 128 127 126 128 126 125 125 125 125 125 125 125 125 125 125 125 125 125 125 125 125 128 127 127 128 128 128 128 128 128 128 128 127 126 125 125 125 125 125 125 125 125 125 125 126 128 
126 128 128 128 128 128 128 128 128 125 125 125 125 125 125 125 125 125 125 125 125 125 125 125 125 128 128 127 127 128 128 128 128 128 127 127 127 126 125 125 125 125 125 125 125 125 125 125 128 128 
126 127 127 128 128 128 128 127 126 126 126 128 126 125 125 125 125 125 125 125 125 125 125 125 125 126 126 126 126 126 126 126 126 126 126 126 126 126 125 125 125 125 125 125 125 125 125 125 128 126 
128 128 127 127 128 128 128 127 128 128 128 126 126 125 125 125 125 125 125 125 125 125 125 125 125 125 125 125 125 125 125 125 125 125 125 125 125 125 125 125 125 125 125 125 125 125 125 125 128 128 
128 128 126 128 128 126 128 126 126 126 128 126 126 125 125 125 125 125 125 125 125 126 128 126 126 128 126 128 126 125 126 126 126 126 126 126 126 126 125 125 125 125 126 126 126 126 125 125 126 128 
126 128 128 128 128 128 128 128 126 126 128 128 126 126 128 126 128 126 125 125 125 128 126 128 128 126 128 126 126 125 128 128 128 128 128 128 128 126 125 125 125 126 128 128 126 126 125 125 126 128 
126 128 128 128 126 126 126 128 128 128 128 128 128 126 126 126 128 126 125 125 125 126 128 128 128 128 128 126 128 125 126 126 128 126 128 128 128 126 126 126 126 128 128 128 126 125 125 125 126 128 
126 127 128 128 128 127 127 127 128 128 128 128 128 128 128 128 126 128 125 125 125 128 128 128 128 127 127 128 125 125 125 126 126 127 128 128 127 128 127 127 127 127 127 127 126 126 125 126 126 126 
126 128 128 128 128 128 128 128 128 127 128 128 127 128 128 128 128 128 125 125 125 126 128 128 128 128 128 128 125 125 125 128 128 127 128 128 128 128 127 128 127 127 128 128 128 126 128 126 128 128 
126 127 128 128 126 127 127 128 128 128 128 128 128 128 128 127 128 126 125 125 125 126 128 127 127 127 127 128 126 128 126 126 127 127 128 128 128 128 128 128 127 128 128 127 128 128 128 127 126 128 
126 126 128 128 128 128 127 127 127 128 128 128 128 127 127 126 126 128 125 125 125 126 128 127 128 128 127 128 128 128 128 127 127 128 128 127 127 127 127 128 128 128 128 128 128 128 128 128 127 127 
126 126 128 128 126 128 128 128 128 128 127 126 128 126 128 126 128 126 125 125 125 126 128 126 128 126 126 128 127 128 128 128 128 128 127 127 127 127 127 127 127 128 128 126 127 127 127 128 127 127 
126 128 128 128 127 128 128 128 127 128 128 128 128 125 125 125 125 125 125 125 125 125 125 125 125 125 126 128 127 127 127 127 128 128 128 128 128 128 128 128 127 126 128 128 127 127 128 128 127 128 
127 128 128 128 127 128 127 128 126 127 128 128 128 125 125 125 125 125 125 125 125 125 125 125 125 125 128 127 128 128 127 127 126 128 127 127 127 127 127 128 127 128 128 127 128 128 127 127 127 128 
126 128 128 128 128 128 126 127 128 126 127 128 126 125 125 125 125 125 125 125 125 125 125 125 125 125 126 127 128 128 128 128 128 128 128 128 127 127 128 128 128 128 128 128 127 128 128 126 127 127 
127 128 128 128 125 125 125 125 125 125 125 125 125 125 125 125 125 125 125 125 125 125 125 125 125 125 128 127 128 128 128 128 127 127 127 128 128 128 128 128 127 127 127 127 126 128 128 128 128 128 
128 127 126 126 125 126 128 128 128 127 127 127 126 125 125 125 125 125 125 125 125 125 125 125 125 125 126 127 128 128 128 128 127 128 128 128 127 127 127 127 128 128 128 128 126 126 126 128 128 128 
128 126 126 128 125 128 127 128 128 128 128 128 126 125 125 125 125 125 125 125 125 125 125 125 125 125 128 127 127 128 128 128 127 128 128 128 126 126 128 128 126 126 126 125 125 125 125 125 126 128 
126 126 126 126 125 126 126 126 127 126 128 128 128 125 125 125 125 125 125 125 125 125 125 125 125 125 126 128 126 128 128 128 128 126 128 128 126 125 125 125 125 125 125 125 125 125 126 125 128 128 
126 125 125 125 125 125 125 125 127 127 127 128 128 125 125 125 125 125 125 125 125 125 125 125 125 125 126 126 128 126 128 126 128 126 128 125 125 125 125 125 125 125 125 125 125 125 126 125 128 128 
128 125 125 125 125 125 125 125 126 128 128 128 126 125 125 125 125 125 125 125 125 125 125 125 125 125 125 125 125 125 125 125 125 125 125 125 125 125 125 125 125 125 125 125 126 128 128 125 127 127 
126 125 125 125 125 125 125 125 126 128 128 128 128 126 127 127 127 126 128 126 127 127 127 127 127 128 127 127 126 128 126 126 126 126 126 126 126 125 125 125 125 125 125 125 127 127 127 125 127 126 
128 125 166 125 125 125 125 125 128 127 128 128 128 128 127 127 128 128 128 127 128 127 128 128 128 128 127 127 126 127 127 128 128 128 127 128 128 128 127 127 127 127 126 127 127 127 127 127 127 126 
126 125 125 125 125 125 125 125 126 127 127 127 128 128 128 128 127 127 128 128 128 128 128 127 127 128 128 128 128 128 128 126 128 128 128 128 127 128 127 128 128 128 128 127 128 127 128 128 128 128 
128 126 128 126 128 128 126 126 128 126 126 126 127 127 126 127 127 127 127 127 127 128 127 126 127 127 127 126 126 128 128 126 128 126 127 128 128 128 126 126 126 126 126 126 128 128 128 128 128 126 
