133 133 133 133 133 133 133 133 133 138 133 138 133 138 133 138 133 138 133 138 133 138 133 138 133 138 133 138 133 138 133 138 133 138 133 138 133 138 133 138 133 138 133 138 133 138 133 133 133 133 
133 125 125 125 125 125 133 133 133 137 133 137 133 137 133 137 133 137 133 137 133 137 133 137 133 137 133 137 133 137 133 137 133 137 133 137 133 137 133 137 133 137 133 137 133 137 133 133 133 133 
133 125 125 125 125 125 133 133 138 125 125 125 125 125 125 125 125 125 125 125 125 125 125 125 125 125 125 125 125 125 125 125 125 125 125 125 125 125 125 125 125 125 125 125 125 125 138 133 133 133 
133 125 125 125 125 125 133 133 137 125 125 125 125 125 125 125 125 125 125 125 125 125 125 125 125 125 125 125 125 125 125 125 125 125 125 125 125 125 125 125 125 125 125 125 125 125 137 133 133 133 
135 125 125 125 125 125 133 133 138 125 125 125 125 125 125 125 125 125 125 125 125 125 125 125 125 125 125 125 125 125 125 125 125 125 125 125 125 125 125 125 125 125 125 125 125 125 138 133 135 135 
133 125 125 125 125 125 133 133 137 125 125 125 125 125 125 125 125 125 125 125 125 125 125 125 125 125 125 125 125 125 125 125 125 125 125 125 125 125 125 125 125 125 125 125 125 125 137 135 135 135 
135 133 125 125 125 133 133 133 134 125 125 125 125 125 125 125 125 125 125 125 125 125 125 125 125 125 125 125 125 125 125 125 125 125 125 125 125 125 125 125 125 125 125 125 125 125 138 133 134 135 
133 135 125 125 125 125 125 125 125 125 125 125 125 125 125 125 125 125 125 125 125 125 125 125 125 125 125 125 125 125 125 125 125 125 125 125 125 125 125 125 125 125 125 125 125 125 137 134 135 133 
133 133 125 125 125 125 125 125 125 125 125 125 125 125 125 125 125 125 125 125 125 125 125 125 125 125 125 125 125 125 125 125 125 125 125 125 125 125 125 125 125 125 125 125 125 125 138 135 135 133 
135 133 125 125 125 125 125 125 125 125 125 125 125 125 125 125 125 125 125 125 125 125 125 125 125 125 125 125 125 125 125 125 125 125 125 125 125 125 125 125 125 125 125 125 125 125 137 133 134 135 
133 133 133 135 133 135 135 133 138 125 125 125 125 125 125 125 125 125 125 125 125 125 125 125 125 125 125 125 125 125 125 125 125 125 125 125 125 125 125 125 125 125 125 125 125 125 138 135 133 133 
133 135 135 135 133 135 135 133 137 125 125 125 125 125 125 125 125 125 125 125 125 125 125 125 125 125 125 125 125 125 125 125 125 125 125 125 125 125 125 125 125 125 125 125 125 125 137 133 135 133 
135 135 133 135 133 135 135 133 133 138 133 133 138 125 125 125 125 125 125 138 133 138 133 138 133 138 134 138 125 125 125 138 133 138 133 134 133 138 133 138 134 138 133 138 133 138 133 134 133 135 
133 134 134 135 134 133 134 133 133 137 133 135 137 125 125 125 125 125 125 137 133 137 134 137 133 137 133 137 125 125 125 137 134 137 133 137 133 137 134 137 133 137 134 137 133 137 134 135 134 135 
133 135 133 134 135 133 134 135 135 133 133 135 133 133 138 125 125 138 133 138 134 138 133 138 133 138 134 138 125 125 125 138 133 134 133 135 135 134 133 135 134 134 133 135 135 133 133 135 135 135 
135 134 135 133 135 133 135 135 135 135 135 135 135 133 137 125 125 137 133 137 133 137 133 137 134 137 133 137 125 125 125 137 133 135 134 134 135 134 135 135 133 134 135 135 133 135 135 134 135 133 
133 135 134 135 135 134 134 135 135 134 135 133 135 133 138 125 125 125 125 125 125 125 125 125 125 125 125 125 125 125 125 125 125 125 125 125 125 125 125 125 125 125 133 135 133 135 133 134 134 133 
134 135 134 135 133 135 133 135 135 134 135 133 135 133 137 125 125 125 125 125 125 125 125 125 125 125 125 125 125 125 125 125 125 125 125 125 125 125 125 125 125 125 133 135 135 134 135 135 135 133 
133 134 135 134 135 134 134 133 135 135 134 133 135 134 133 138 133 138 134 138 133 138 134 138 133 138 133 138 134 138 134 138 133 138 133 138 133 125 125 125 125 125 125 134 135 135 134 135 135 135 
135 133 135 135 133 135 133 135 135 135 135 135 135 133 133 137 133 137 133 137 134 137 134 137 133 137 134 137 133 137 134 137 133 137 133 137 133 125 125 125 125 125 125 133 135 134 135 135 133 135 
133 134 134 133 135 134 135 134 135 135 135 135 135 134 135 135 133 135 134 134 133 135 133 135 134 133 135 134 133 135 134 134 135 133 135 133 135 134 134 135 125 125 125 135 134 135 135 135 135 133 
135 135 135 135 134 133 134 133 135 133 134 135 135 135 135 135 135 135 135 135 135 133 134 135 135 135 134 135 134 135 135 133 135 133 135 134 134 135 135 135 133 125 125 133 135 135 135 135 133 134 
133 135 134 134 135 133 133 135 135 133 135 135 135 134 135 135 133 133 135 135 134 134 135 135 134 134 135 135 135 134 135 135 135 134 135 134 133 135 125 125 125 125 125 125 125 125 125 133 135 133 
133 135 135 135 134 135 135 135 135 135 135 133 133 134 133 125 125 133 133 134 135 133 135 134 134 134 133 135 133 134 135 134 134 134 133 135 135 125 125 125 125 125 125 125 125 125 125 133 134 134 
134 135 135 135 135 135 135 133 135 134 135 134 133 135 133 125 125 125 125 125 125 125 125 125 125 125 125 125 125 125 125 133 135 134 135 135 133 125 125 125 125 125 125 125 125 125 125 135 135 133 
133 133 135 133 135 135 135 133 133 135 135 134 135 135 133 125 125 133 134 133 134 134 125 125 125 125 125 125 125 125 125 125 125 133 135 133 133 125 125 125 125 125 125 125 125 125 125 133 134 135 
135 133 133 135 134 133 133 135 133 133 135 135 135 133 133 133 133 134 135 134 135 133 125 125 125 125 125 125 125 125 125 125 125 125 125 125 125 125 125 125 125 125 125 125 125 125 125 133 135 134 
133 135 135 135 135 135 135 135 135 133 133 133 133 135 134 135 134 134 134 135 134 134 125 125 125 125 125 125 125 125 125 125 125 125 125 125 125 125 125 125 125 125 138 125 125 125 125 133 135 134 
133 133 135 135 133 133 133 138 133 135 135 134 134 135 133 135 135 134 134 134 135 135 125 125 125 125 125 133 133 125 125 125 125 125 125 125 125 125 125 125 125 125 137 125 125 125 125 133 135 135 
135 135 135 135 133 135 133 137 133 133 133 135 135 133 133 133 133 135 134 135 134 135 125 125 125 125 125 134 134 135 133 135 133 133 134 134 133 125 125 125 125 125 125 125 125 125 125 135 135 134 
133 135 135 135 135 133 125 125 125 135 135 133 135 135 135 135 135 135 135 134 134 134 133 125 125 125 133 135 134 134 135 134 135 135 134 134 133 125 125 125 125 125 125 125 125 125 125 135 135 135 
133 135 133 133 133 135 125 125 125 133 133 135 133 133 135 133 133 133 135 135 133 135 133 133 133 125 125 133 134 134 135 134 134 135 133 134 135 134 125 125 125 125 125 125 125 125 125 133 135 133 
135 135 125 125 125 125 125 125 125 133 135 135 135 134 135 135 133 134 135 135 133 135 135 133 135 125 125 133 135 135 135 134 133 135 133 133 135 135 133 125 125 125 125 125 125 125 125 133 133 135 
133 133 125 125 125 125 125 125 125 135 133 135 135 135 133 135 133 135 134 135 133 135 134 135 134 125 125 135 134 135 135 134 135 134 135 135 134 135 133 125 125 125 125 125 125 125 125 135 135 133 
134 133 125 125 133 135 134 133 135 135 135 134 134 135 135 125 125 125 133 135 135 135 135 135 133 125 125 134 135 135 133 133 133 135 134 135 133 135 135 125 125 125 125 125 125 125 125 133 135 135 
135 135 125 125 134 134 135 135 133 133 135 135 135 135 133 125 125 125 133 135 135 135 135 133 133 125 125 133 134 134 134 135 135 134 135 135 133 135 133 133 135 125 125 125 125 125 125 133 135 135 
135 135 125 125 134 135 134 135 135 135 135 134 134 135 133 125 125 125 125 125 125 125 125 125 125 125 125 135 134 135 135 135 135 133 135 135 135 135 135 133 135 125 125 125 125 125 125 133 134 135 
134 134 125 125 135 135 134 134 133 133 135 134 133 135 133 125 125 125 134 134 134 133 134 134 133 125 125 133 135 135 135 135 133 135 135 135 133 134 135 135 133 133 133 125 125 135 133 135 135 133 
134 134 125 125 134 135 134 135 134 135 135 135 135 135 135 135 134 135 133 135 133 133 135 134 133 125 125 135 133 135 134 135 134 134 133 135 135 135 133 135 135 133 135 125 125 134 135 134 135 135 
135 134 125 125 134 134 133 133 133 135 134 135 134 133 134 135 134 134 134 135 133 133 134 135 133 125 125 125 125 133 135 134 135 135 135 135 133 133 135 134 135 133 134 125 125 133 135 134 135 135 
135 135 125 125 125 125 125 125 125 125 125 125 125 125 125 125 125 125 125 125 125 125 125 125 125 125 125 125 125 125 125 125 125 125 125 125 125 125 125 133 134 135 133 125 125 133 134 135 134 133 
133 135 125 125 125 125 125 125 125 125 125 125 125 125 125 125 125 125 125 125 125 125 125 125 125 125 125 125 125 125 125 125 125 125 125 125 125 125 125 133 133 135 135 125 125 135 133 134 135 133 
134 134 125 125 133 134 134 133 134 133 125 125 133 135 133 135 133 135 135 135 133 133 133 133 133 125 125 133 135 133 135 133 135 135 134 135 133 125 125 125 135 135 135 125 125 134 135 133 135 135 
135 133 125 125 134 135 135 135 134 133 125 125 125 125 133 135 135 133 135 135 135 135 133 135 135 125 125 135 135 135 135 135 134 135 135 135 135 133 125 125 133 134 135 125 125 133 134 135 135 135 
133 135 125 125 133 135 135 135 133 134 125 125 125 125 133 135 135 133 133 135 133 135 135 133 133 125 125 133 134 135 135 135 135 135 135 134 135 133 125 125 125 135 135 125 125 134 135 135 135 134 
133 125 125 125 125 133 135 135 135 134 133 133 125 125 125 125 133 135 135 133 135 135 125 125 125 125 125 135 133 135 133 133 133 135 135 135 135 135 135 125 125 133 133 125 125 133 135 135 135 133 
135 125 125 125 125 135 135 135 134 133 133 133 125 125 125 125 133 135 133 133 135 133 125 125 125 125 125 133 135 135 135 134 135 135 133 135 135 133 133 125 125 125 125 125 125 133 135 135 133 133 
133 125 125 125 125 133 135 135 133 134 134 135 133 133 125 125 125 125 125 125 125 125 125 125 125 125 125 133 135 135 135 135 135 133 135 134 134 135 135 133 125 125 125 125 125 133 133 135 134 133 
135 125 125 125 125 133 135 135 135 133 133 133 133 133 125 125 125 125 125 125 125 125 125 125 125 133 135 134 133 135 134 134 134 133 133 135 135 134 134 135 133 133 133 133 133 133 135 134 134 133 
135 133 135 134 134 134 134 135 135 133 135 134 133 133 133 133 133 133 133 134 134 134 134 134 134 135 135 134 134 135 133 134 134 135 134 135 133 135 134 133 135 135 135 135 133 134 135 134 135 133 
