132 131 130 132 130 132 130 131 132 131 130 130 132 132 131 132 131 132 130 132 130 132 130 132 130 132 130 132 130 132 132 130 132 130 132 132 131 132 131 131 131 130 132 131 130 131 132 132 132 130 
131 129 129 129 129 129 129 130 131 132 130 129 129 129 129 129 129 129 129 129 129 129 129 129 129 129 129 129 129 129 132 131 131 131 130 132 132 132 132 131 132 130 132 130 132 132 131 131 132 130 
132 129 129 129 129 129 129 129 129 129 129 129 129 129 129 129 129 129 129 129 129 129 129 129 129 129 129 129 129 129 130 132 132 132 131 131 132 132 131 132 132 132 131 132 132 132 132 132 132 131 
130 129 129 129 129 129 129 129 129 129 129 129 129 129 129 129 129 129 129 129 129 129 129 129 129 129 129 129 129 129 129 131 132 132 132 132 130 132 132 132 130 132 130 132 131 131 131 130 131 131 
131 129 129 129 129 129 129 132 130 132 129 129 129 129 129 129 129 129 129 129 129 129 129 129 129 129 129 129 129 129 129 129 129 129 129 129 129 129 129 129 129 129 129 129 129 129 129 129 130 131 
130 132 130 130 131 130 130 132 132 130 129 129 129 129 129 129 129 129 129 129 129 129 129 129 129 129 129 129 129 129 129 129 129 129 129 129 129 129 129 129 129 130 131 132 130 130 130 129 131 131 
131 131 132 132 131 132 132 130 132 130 129 129 129 129 129 129 129 129 129 129 129 129 129 129 129 129 129 129 129 129 129 130 132 130 130 132 130 130 130 129 129 130 132 130 132 131 130 129 132 130 
131 132 131 131 131 132 132 132 130 129 129 129 129 129 129 129 129 129 129 129 129 129 129 129 129 129 129 129 129 129 129 130 132 131 131 132 131 132 130 129 129 129 129 130 132 132 132 129 130 131 
131 131 132 132 132 130 131 130 130 129 129 129 129 129 129 129 129 129 129 129 129 129 129 129 129 129 129 129 129 129 129 132 131 132 131 131 132 131 130 129 129 129 129 130 132 130 130 129 130 131 
132 132 131 132 132 130 132 132 129 129 129 129 129 129 129 129 129 129 129 129 129 129 129 129 129 129 129 129 129 129 129 132 132 132 132 132 132 132 130 129 129 129 129 131 132 132 129 129 129 132 
130 132 132 132 131 131 132 132 129 129 129 129 129 129 129 129 129 129 129 129 129 129 129 129 129 129 129 129 129 129 129 130 132 131 131 130 132 132 130 129 129 130 132 132 132 130 129 129 129 131 
131 131 132 131 131 132 132 130 129 129 129 129 129 129 129 129 129 129 129 129 129 129 129 129 129 129 129 129 129 129 129 132 132 132 132 131 132 130 130 129 129 132 132 131 131 129 129 129 129 132 
132 132 130 131 132 131 132 132 129 129 129 129 129 129 129 129 129 129 129 129 129 129 129 129 129 129 129 129 129 129 129 130 130 131 132 132 132 132 132 129 129 132 132 131 130 129 129 129 129 131 
130 132 132 132 131 132 132 131 130 129 129 129 129 129 129 129 129 129 129 129 129 129 129 129 129 129 129 129 129 129 129 130 132 132 131 132 131 132 130 129 129 131 132 132 129 129 129 129 129 130 
131 131 130 131 131 132 130 132 131 129 129 129 129 129 129 129 129 129 129 129 129 129 129 129 129 129 129 129 129 129 130 132 132 132 132 132 131 130 129 129 129 131 132 131 129 129 129 129 129 132 
130 131 129 129 129 129 129 129 130 129 129 131 132 131 130 131 130 130 129 129 132 131 131 130 130 132 130 132 132 130 131 132 132 132 131 132 131 132 129 129 129 132 132 132 129 129 129 129 132 132 
131 131 129 129 129 129 129 129 129 129 129 131 132 132 132 132 131 130 129 129 131 131 132 132 132 131 132 132 132 131 132 132 131 132 130 130 132 130 129 129 130 132 132 130 129 129 129 129 132 132 
130 131 129 129 129 129 129 129 129 129 129 129 132 132 132 132 131 130 129 129 130 132 132 132 131 132 132 131 130 131 132 132 131 132 132 132 129 129 129 129 129 130 132 132 130 129 129 130 131 132 
131 132 129 129 129 129 129 129 129 129 129 129 131 131 131 130 131 131 129 129 129 129 129 129 129 129 129 129 129 129 129 130 131 132 130 129 129 129 129 129 129 130 132 131 130 129 129 130 132 130 
130 130 129 129 129 129 129 129 129 129 129 129 129 131 132 132 132 131 129 129 129 129 129 129 129 129 129 129 129 129 129 129 129 129 129 129 129 129 129 129 129 132 132 131 132 129 129 132 132 130 
131 132 130 129 129 129 129 129 129 129 129 129 129 132 131 130 132 130 129 129 129 129 129 129 129 129 129 129 129 129 129 129 129 129 129 129 129 129 129 129 130 130 132 132 130 129 129 132 132 130 
132 132 130 129 129 129 129 129 129 129 129 129 129 129 130 130 131 132 130 131 130 132 130 131 131 130 132 130 132 132 130 130 131 130 132 132 132 131 130 132 132 132 132 132 132 129 129 131 132 132 
132 132 132 130 129 129 129 129 129 129 129 129 129 129 130 132 132 132 132 132 132 132 131 132 132 131 132 130 132 132 131 132 132 132 131 132 131 132 132 131 132 131 132 131 130 129 129 131 131 131 
130 132 131 130 129 129 129 129 129 129 129 129 129 131 132 132 132 130 132 132 132 132 132 130 132 131 131 132 132 132 131 132 132 130 132 132 132 131 130 131 132 132 131 132 131 129 129 131 132 132 
130 130 132 131 132 130 130 132 131 132 130 131 132 132 130 132 131 132 132 132 131 131 130 132 130 132 130 130 132 132 132 132 131 132 131 132 131 129 129 129 129 131 132 132 130 129 129 131 132 132 
131 132 131 132 132 132 131 132 132 132 130 132 132 131 131 129 129 129 129 129 129 129 129 129 129 130 130 132 131 131 131 132 130 130 131 131 132 129 129 129 129 130 130 132 130 129 129 132 131 132 
130 132 132 132 132 132 132 132 132 132 132 130 132 130 130 129 129 129 129 129 129 129 129 129 129 129 129 130 132 131 132 132 131 130 132 132 131 129 129 129 129 129 129 129 129 129 129 130 132 132 
130 132 132 130 132 131 132 130 132 132 132 132 132 131 131 129 129 130 130 132 130 130 132 129 129 129 129 132 131 131 132 132 131 131 130 132 130 129 129 129 129 129 129 129 129 129 129 132 132 132 
132 131 131 132 131 132 132 132 130 131 132 132 132 132 131 129 129 132 132 132 132 130 129 129 129 129 129 130 131 131 130 130 132 131 132 132 130 129 129 129 129 131 129 129 129 129 129 131 132 131 
132 132 131 132 132 131 132 132 132 130 132 130 130 132 130 129 129 130 132 132 130 129 129 129 129 129 129 129 130 130 131 132 132 132 130 132 131 129 129 129 129 132 131 132 130 130 129 132 132 130 
130 130 132 132 132 130 132 132 132 132 130 131 132 132 132 129 129 132 132 130 130 129 129 129 129 129 129 129 130 131 132 132 132 131 131 132 132 130 130 132 132 132 132 132 130 132 129 130 132 131 
132 130 130 132 132 130 132 131 131 132 132 132 132 132 130 129 129 132 132 132 131 129 129 129 129 129 129 130 132 130 132 131 132 130 132 132 132 130 132 132 132 131 132 132 132 132 129 131 132 130 
132 132 131 129 129 130 130 132 132 132 132 132 132 131 132 129 129 130 132 132 132 130 129 129 129 129 131 132 130 132 132 130 129 129 130 132 130 132 132 131 132 131 132 132 130 132 129 130 132 130 
131 132 131 129 129 130 132 130 131 132 132 132 132 132 131 129 129 132 132 131 132 130 132 130 129 129 130 132 129 129 129 129 129 129 132 130 131 132 132 132 131 132 130 132 132 132 129 131 132 132 
130 130 130 129 129 132 130 132 131 132 131 132 130 131 132 129 129 130 132 131 132 132 132 131 129 129 129 129 129 129 129 129 129 129 132 132 131 132 129 129 129 129 129 129 129 130 129 132 132 131 
132 132 131 129 129 130 132 131 131 132 131 130 132 132 131 129 129 131 132 132 132 131 132 131 129 130 132 130 129 129 129 129 129 129 131 132 132 130 129 129 129 129 129 129 129 129 129 132 132 132 
132 132 132 129 129 132 132 132 132 132 131 131 132 132 131 129 129 131 132 132 132 132 131 132 129 132 132 132 130 129 129 129 130 132 130 132 130 131 129 129 129 129 129 129 129 129 129 130 132 132 
130 132 130 129 129 130 132 130 132 130 131 131 131 132 132 129 129 130 132 132 130 132 131 132 129 132 132 132 132 132 132 130 132 132 132 132 132 130 132 129 129 129 129 129 129 129 129 130 132 130 
132 132 130 129 129 130 132 132 132 132 132 132 131 132 131 129 129 132 131 132 132 132 132 132 129 132 132 132 132 132 132 132 130 132 130 130 131 132 130 129 129 129 129 129 129 129 129 130 132 130 
132 131 132 129 129 130 132 131 131 132 132 130 132 132 131 129 129 130 132 132 132 132 130 132 129 132 132 132 132 131 132 132 132 132 132 132 130 132 132 129 129 129 129 129 129 130 132 132 130 132 
130 132 130 129 129 130 132 130 132 131 131 132 132 130 130 129 129 132 132 130 130 132 131 130 129 130 131 132 132 130 132 132 130 132 130 132 131 132 132 130 129 129 129 129 129 130 130 130 132 132 
132 132 130 129 129 129 129 129 129 129 129 129 129 129 129 129 129 129 129 129 129 129 129 129 129 129 129 129 129 129 129 129 129 129 132 131 132 132 132 132 129 129 129 129 129 130 132 130 132 130 
132 132 132 129 129 132 132 132 132 130 130 132 130 130 129 129 129 129 130 130 132 132 131 130 132 131 132 130 130 132 130 129 129 129 132 131 131 132 130 132 129 129 129 129 129 132 132 130 130 130 
132 130 130 129 129 130 130 132 132 132 132 132 132 130 129 129 129 129 129 131 132 132 132 132 131 131 132 132 132 132 129 129 129 129 129 132 132 132 132 132 129 129 129 129 129 130 132 132 132 132 
130 129 129 129 129 129 129 132 131 132 132 132 130 130 129 129 129 129 129 129 129 130 131 131 132 130 132 132 132 129 129 129 129 129 129 130 131 132 132 132 129 129 129 129 129 130 132 132 132 132 
131 129 129 129 129 129 129 130 131 132 132 132 130 130 130 129 129 129 129 129 129 130 132 132 132 132 131 132 131 129 129 129 129 129 129 129 129 129 129 129 129 129 129 129 129 129 129 129 130 132 
132 129 129 129 129 129 129 132 130 132 132 132 131 132 132 129 129 129 129 129 129 131 132 131 132 131 132 131 131 130 129 129 129 129 129 129 129 129 129 129 129 129 129 129 129 129 129 130 132 132 
132 129 129 129 129 129 132 130 132 132 132 132 131 132 131 130 130 129 129 129 129 130 132 132 132 132 132 132 131 130 130 130 129 129 131 132 132 130 131 131 132 131 131 132 131 132 132 132 132 132 
132 129 129 129 129 129 129 130 132 132 132 132 131 131 132 131 132 130 131 132 132 132 131 132 132 130 132 132 132 132 132 130 131 132 131 132 131 132 132 132 132 130 132 132 132 132 132 132 132 130 
130 132 131 132 132 132 132 130 132 131 130 131 130 130 131 130 132 131 130 131 131 130 132 132 131 130 130 130 132 132 130 132 130 130 131 132 132 132 132 132 130 132 132 132 130 130 130 132 132 130 
