124 124 124 124 124 124 124 124 124 124 124 124 124 124 124 124 124 124 124 124 124 124 124 124 124 124 124 124 124 124 124 124 124 124 124 124 124 124 124 124 124 124 124 124 124 124 124 124 124 124 
124 125 125 125 125 125 125 124 124 124 124 124 124 124 124 124 124 124 124 124 124 124 124 124 124 124 124 124 124 124 124 124 124 124 124 124 124 124 124 124 124 124 124 124 124 124 124 124 124 124 
124 125 125 125 125 125 125 124 124 124 124 124 124 124 125 125 124 124 124 124 124 124 124 124 124 124 124 124 124 124 124 124 124 124 124 124 124 124 124 124 124 124 124 124 124 124 124 124 124 124 
124 125 125 125 125 125 125 124 124 124 124 125 125 125 125 125 125 125 125 125 125 125 124 124 124 124 124 124 125 125 125 125 125 125 125 125 125 125 125 125 125 125 125 124 124 124 124 124 124 124 
124 125 125 125 125 125 125 124 124 124 124 125 125 125 125 125 125 125 125 125 125 125 124 124 124 124 124 124 125 125 125 125 125 125 125 125 125 125 125 125 125 125 125 124 124 124 124 124 124 124 
124 124 124 124 124 125 125 124 124 124 124 124 124 124 125 125 124 124 124 124 124 125 124 124 124 124 125 125 125 125 125 125 125 125 125 125 125 124 124 124 125 125 125 124 124 124 124 124 124 124 
124 124 124 124 124 125 125 124 124 124 124 124 124 124 125 125 124 124 124 124 125 125 125 125 125 125 125 125 125 125 125 125 125 125 125 125 125 124 124 124 125 125 125 125 125 124 124 124 124 124 
124 124 124 124 124 125 125 125 125 125 125 125 125 125 125 125 124 124 124 124 125 125 125 125 125 125 125 125 125 125 125 125 125 125 125 124 124 124 124 124 125 125 125 125 125 124 124 124 124 124 
124 124 124 124 124 125 125 125 125 125 125 125 125 125 125 125 125 125 125 125 125 125 124 124 124 124 124 124 124 124 124 124 124 124 124 124 124 124 124 124 124 124 124 125 125 124 124 124 124 124 
124 124 124 124 124 124 124 124 124 124 124 124 124 124 125 125 125 125 125 125 125 125 124 124 124 124 124 124 124 124 124 124 124 124 124 124 124 124 124 124 124 124 124 125 125 124 124 124 124 124 
124 124 124 124 124 124 124 124 124 124 124 124 124 124 124 124 124 125 125 125 125 124 124 124 124 124 124 124 124 124 124 124 124 124 124 124 124 124 124 124 124 124 124 125 125 124 124 124 124 124 
124 124 124 124 124 124 124 124 124 124 124 124 124 124 124 124 124 125 125 125 125 124 124 124 124 124 124 125 125 124 124 124 124 124 124 124 124 124 124 124 124 125 125 125 125 125 125 124 124 124 
124 124 124 124 124 124 124 124 124 124 124 124 124 124 124 124 124 125 125 125 125 125 124 124 124 124 124 125 125 124 124 124 124 124 124 124 124 124 124 124 124 125 125 125 125 125 125 124 124 124 
124 124 124 124 124 124 124 124 124 124 124 124 124 124 124 124 124 124 125 125 125 125 124 124 124 124 124 125 125 124 124 124 124 124 124 125 125 125 125 125 125 125 125 125 125 125 125 124 124 124 
124 124 124 125 125 125 125 125 125 125 125 125 124 124 124 124 124 124 124 125 125 125 124 124 124 125 125 125 125 125 125 124 124 124 125 125 125 125 125 125 125 125 125 125 125 125 125 125 124 124 
124 124 124 125 125 125 125 125 125 125 125 124 124 124 124 124 124 124 124 125 125 125 124 124 124 125 125 125 125 125 125 124 125 125 125 125 125 125 125 125 125 125 125 125 125 125 125 125 124 124 
124 124 124 125 125 125 125 125 125 125 125 124 124 124 124 124 124 124 124 125 125 124 124 124 124 125 125 125 125 125 125 125 125 125 125 125 125 125 125 125 125 125 125 125 125 125 125 125 124 124 
124 124 124 125 125 125 125 125 125 125 125 124 124 124 124 124 124 124 124 125 125 124 124 124 124 125 125 125 125 125 125 125 125 125 125 125 125 125 124 124 124 124 124 125 125 125 125 124 124 124 
124 124 124 125 125 125 125 125 125 125 125 124 124 124 125 125 124 124 124 125 125 124 124 124 124 125 125 125 125 125 125 125 125 125 125 124 124 124 124 124 124 124 124 125 125 125 125 124 124 124 
124 124 124 125 125 125 125 125 125 125 124 124 124 124 125 125 124 124 124 125 125 124 124 124 124 124 125 125 125 125 125 125 125 124 124 124 124 124 124 124 124 124 124 124 125 125 124 124 124 124 
124 124 124 125 125 125 125 125 125 125 125 125 125 125 125 125 125 125 125 125 125 124 124 124 124 124 125 125 125 125 125 124 124 124 124 124 124 125 125 125 124 124 124 124 125 125 124 124 124 124 
124 124 124 124 124 125 125 125 125 125 125 125 125 125 125 125 125 125 125 125 125 124 124 124 124 124 124 124 124 124 124 124 124 124 124 124 124 125 125 125 124 124 124 125 125 125 125 125 124 124 
124 124 124 124 124 124 124 124 124 124 124 124 124 124 125 125 124 124 124 124 124 124 124 124 124 124 124 124 124 124 124 124 124 124 124 125 125 125 125 125 124 124 124 125 125 125 125 125 124 124 
124 124 124 124 124 124 124 124 124 124 124 124 124 124 125 125 124 124 124 124 124 124 124 124 124 124 124 124 124 124 124 124 124 124 124 125 125 125 125 125 124 124 124 124 125 125 124 124 124 124 
124 124 124 124 124 124 124 124 124 124 124 124 124 124 125 125 124 124 124 124 124 124 124 124 124 124 124 124 124 124 124 125 125 125 125 125 125 125 125 125 124 124 124 124 125 125 124 124 124 124 
124 124 124 124 124 124 124 124 124 124 124 124 124 124 125 125 125 125 125 125 125 125 125 125 125 125 125 125 125 125 125 125 125 125 125 125 125 125 125 124 124 124 124 125 125 125 125 124 124 124 
124 124 124 124 124 124 124 124 124 124 124 124 124 124 125 125 125 125 125 125 125 125 125 125 125 125 125 125 125 125 125 125 125 125 125 125 125 125 124 124 124 124 124 125 125 125 125 124 124 124 
124 124 124 124 124 124 124 124 124 124 124 124 124 124 125 125 124 124 124 124 124 124 124 124 125 125 124 124 124 124 124 124 124 124 124 124 124 124 124 124 124 125 125 125 125 125 125 124 124 124 
124 124 124 124 124 124 124 124 124 124 124 124 124 124 125 125 124 124 124 124 124 124 124 124 124 124 124 124 124 124 124 124 124 124 124 124 124 124 124 124 124 125 125 125 125 125 125 124 124 124 
124 124 124 124 124 124 124 124 124 124 124 124 124 124 125 125 124 124 124 124 124 124 124 124 124 124 124 124 124 124 124 124 124 124 124 124 124 124 124 124 124 125 125 125 125 125 125 124 124 124 
124 124 124 124 125 125 125 125 125 125 125 125 125 125 125 125 125 125 125 125 125 125 125 125 125 125 125 125 125 125 125 125 125 125 125 125 125 125 125 125 125 125 125 125 125 125 125 124 124 124 
124 124 124 124 125 124 124 125 124 124 124 124 124 125 125 125 125 125 125 125 125 125 125 125 125 125 125 125 125 125 125 125 125 125 125 125 125 125 125 125 125 125 125 125 125 125 125 124 124 124 
124 124 124 124 125 124 124 125 124 124 124 124 124 125 125 125 125 124 124 124 124 124 124 124 124 124 124 124 124 124 124 125 125 124 124 124 124 124 124 124 124 125 125 125 125 124 124 124 124 124 
124 124 124 124 125 124 125 125 124 124 124 124 124 125 125 125 125 124 124 124 124 124 124 124 124 124 124 124 124 124 124 125 125 124 124 124 124 124 124 124 124 125 125 125 124 124 124 124 124 124 
124 124 124 124 125 124 125 125 124 124 124 124 124 125 125 125 125 124 124 124 124 124 124 124 124 124 124 124 124 124 124 125 125 124 124 124 124 124 125 125 125 125 125 125 124 124 124 124 124 124 
124 124 124 124 125 124 125 124 124 124 124 124 124 125 125 125 125 124 124 124 124 124 124 124 124 124 124 124 124 124 125 125 125 125 124 124 124 124 125 125 125 125 125 125 124 124 124 124 124 124 
124 124 124 124 125 125 125 124 124 124 124 124 124 125 125 125 125 124 124 124 124 124 124 124 124 124 124 124 124 124 125 125 125 125 124 124 124 124 124 124 124 124 124 124 124 124 124 124 124 124 
124 124 124 124 125 124 124 124 124 124 124 124 124 125 125 125 125 124 124 124 124 124 124 124 124 124 124 124 124 124 125 125 125 125 124 124 124 124 124 124 124 124 124 124 124 124 124 124 124 124 
124 124 124 124 125 124 124 124 124 124 125 125 125 125 125 125 125 125 125 125 124 124 124 125 125 125 125 124 124 124 124 124 124 124 124 124 124 124 124 124 124 124 124 125 125 125 125 124 124 124 
124 124 124 124 125 124 124 124 124 124 125 125 125 125 125 125 125 125 125 125 124 124 124 125 125 125 125 125 125 124 124 124 124 124 124 124 124 124 124 124 124 124 124 125 125 125 125 124 124 124 
124 124 124 124 125 124 124 124 124 124 125 125 125 125 125 125 125 125 125 125 124 124 124 125 125 125 125 125 124 124 124 124 124 124 124 124 124 124 124 124 124 124 125 125 125 125 125 124 124 124 
124 124 124 124 125 124 124 124 124 124 125 125 125 125 125 125 125 125 125 125 124 124 124 125 125 125 124 124 124 124 124 124 124 124 124 124 124 124 124 124 124 125 125 125 125 125 125 125 124 124 
124 124 124 125 125 125 125 125 125 125 125 125 125 125 125 125 125 125 125 125 124 124 124 125 125 125 124 124 124 124 124 124 124 124 124 124 124 124 124 124 125 125 125 125 125 125 125 125 124 124 
124 124 124 125 124 124 124 124 124 124 125 125 125 125 125 125 125 125 125 125 124 124 124 125 125 125 124 124 124 124 124 124 124 124 125 125 125 125 125 125 125 125 125 125 125 124 125 125 124 124 
124 124 124 125 124 124 124 124 124 124 125 125 125 125 125 125 125 125 125 125 124 124 124 125 125 125 124 124 124 124 124 124 125 125 125 125 125 125 125 125 125 125 125 124 124 124 125 125 124 124 
124 125 125 125 125 125 124 124 124 124 125 125 125 125 125 125 125 125 125 125 125 125 125 125 125 125 125 125 125 125 125 125 125 125 125 125 125 125 125 125 125 125 125 124 124 124 125 125 124 124 
124 125 125 125 125 125 124 124 124 124 124 124 124 124 124 124 124 124 124 124 124 124 124 124 124 124 124 124 124 124 124 124 124 124 124 125 125 125 125 125 125 125 125 124 124 124 125 125 124 124 
124 125 125 125 125 125 124 124 124 124 124 124 124 124 124 124 124 124 124 124 124 124 124 124 124 124 124 124 124 124 124 124 124 124 124 125 125 125 125 125 125 125 125 124 124 124 124 124 124 124 
124 125 125 125 125 125 124 124 124 124 124 124 124 124 124 124 124 124 124 124 124 124 124 124 124 124 124 124 124 124 124 124 124 124 124 124 124 124 124 124 124 124 124 124 124 124 124 124 124 124 
124 124 124 124 124 124 124 124 124 124 124 124 124 124 124 124 124 124 124 124 124 124 124 124 124 124 124 124 124 124 124 124 124 124 124 124 124 124 124 124 124 124 124 124 124 124 124 124 124 124 
