28 28 28 28 28 28 28 28 28 28 28 28 28 28 28 28 28 28 28 28 28 28 28 28 28 28 28 28 28 28 28 28 28 28 28 28 28 28 28 28 28 28 28 28 28 28 28 28 28 28 
28 28 28 28 28 28 28 28 28 28 28 28 28 28 28 28 28 28 28 28 28 28 28 28 28 28 28 28 28 28 28 28 28 28 28 28 28 28 28 28 28 28 28 28 28 28 28 28 28 28 
28 28 28 28 34 34 34 34 34 34 34 34 34 34 34 34 34 34 34 34 34 34 34 34 34 34 34 34 34 34 34 34 34 34 34 34 34 34 34 34 34 34 34 34 34 34 28 28 28 28 
28 28 28 27 33 33 33 33 33 33 33 33 33 33 33 33 33 33 33 33 33 33 33 33 33 33 33 33 33 33 33 33 33 33 33 33 33 33 33 33 33 33 33 33 33 33 28 28 28 28 
28 28 28 28 34 34 34 34 34 34 34 34 34 34 34 34 34 34 34 34 34 34 34 34 34 34 34 34 34 34 34 34 34 34 34 34 34 34 34 34 34 34 34 34 34 34 28 28 28 28 
28 28 28 28 33 33 33 33 33 33 33 33 33 33 33 33 33 33 33 33 33 33 33 33 33 33 33 33 33 33 33 33 33 33 33 33 33 33 33 33 33 33 33 33 33 33 28 28 28 28 
28 28 28 28 34 34 34 34 34 120 120 20 120 121 120 20 120 20 20 120 20 120 20 20 82 120 20 120 120 20 120 82 120 20 120 20 81 120 20 120 20 34 34 34 34 34 28 28 28 28 
28 28 28 28 33 33 33 33 33 20 20 80 20 20 20 20 90 91 89 20 20 82 20 120 20 20 26 20 20 20 80 20 120 20 20 120 20 120 20 120 81 33 33 33 33 33 28 28 28 28 
28 28 28 28 34 34 34 34 34 120 82 20 120 20 121 120 93 92 94 20 120 20 83 20 20 83 22 120 20 82 20 71 79 79 79 72 20 82 20 121 20 34 34 34 34 34 28 28 28 28 
28 28 28 28 33 33 33 33 33 20 20 80 20 81 20 20 84 85 86 20 20 20 120 20 120 82 22 81 120 20 120 69 76 76 76 70 20 120 20 20 120 33 33 33 33 33 28 28 28 28 
28 28 28 28 34 34 34 34 34 82 120 20 120 20 20 120 58 60 59 120 20 20 20 20 20 83 22 20 20 20 121 69 76 76 76 70 20 20 120 20 81 34 34 34 34 34 28 28 28 28 
28 28 28 28 33 33 33 33 33 83 20 83 20 20 81 20 64 96 66 97 20 120 20 20 120 80 22 120 120 20 20 67 77 77 77 68 120 20 20 120 20 33 33 33 33 33 28 28 28 28 
28 28 28 28 34 34 34 34 34 20 20 81 120 120 120 83 120 26 120 20 20 20 20 120 20 120 22 120 20 20 120 58 60 60 60 59 20 20 81 20 120 34 34 34 34 34 28 28 28 28 
28 28 28 28 33 33 33 33 33 120 120 20 20 20 20 20 20 22 121 20 120 20 121 81 20 20 22 20 20 120 20 61 78 62 78 63 82 20 120 20 81 33 33 33 33 33 47 47 47 47 
28 28 28 28 34 34 34 34 34 81 20 120 121 120 20 82 120 22 120 120 120 82 120 120 81 120 22 82 120 20 120 61 62 62 62 63 120 20 20 120 20 34 34 34 34 34 28 28 28 28 
28 28 28 28 33 33 33 33 33 120 82 104 105 103 81 20 20 17 114 21 21 21 21 21 21 21 42 109 110 111 112 64 65 74 65 66 97 20 121 20 120 33 33 33 33 33 28 28 28 28 
28 28 28 28 34 34 34 34 34 20 120 101 106 102 120 121 80 20 22 44 43 43 43 43 43 45 22 81 83 80 81 82 83 26 120 20 120 20 120 20 20 34 34 34 34 34 28 28 28 28 
28 28 28 28 33 33 33 33 33 20 20 98 99 100 20 120 20 120 22 46 47 47 47 47 47 48 22 81 83 80 81 82 83 22 120 20 82 20 20 81 20 33 33 33 33 33 28 28 28 28 
28 28 28 28 34 34 34 34 34 81 20 58 60 59 120 80 20 82 22 46 47 47 47 47 47 48 22 81 83 80 81 82 83 22 120 20 120 20 121 120 120 34 34 34 34 34 28 28 28 28 
28 28 28 28 33 33 33 33 33 20 120 64 108 66 97 120 20 20 22 46 47 47 47 47 47 48 22 81 83 80 81 82 83 22 82 20 20 20 82 20 20 33 33 33 33 33 28 28 28 28 
28 28 28 28 34 34 34 34 34 20 81 120 26 120 120 20 121 120 22 49 50 50 50 50 50 51 22 81 83 80 81 82 83 22 121 20 81 82 20 82 20 34 34 34 34 34 28 28 28 28 
28 28 28 28 33 33 33 33 33 120 20 120 17 21 21 21 21 21 113 21 21 21 21 21 21 21 41 21 21 21 21 21 21 18 120 120 20 120 20 121 81 33 33 33 33 33 28 28 28 28 
28 28 28 28 34 34 34 34 34 34 34 34 34 34 34 34 34 34 22 34 34 34 34 34 34 34 34 34 34 34 34 34 34 34 34 34 34 34 34 34 34 34 34 34 34 34 28 28 28 28 
28 28 28 28 33 33 33 33 33 33 33 33 33 33 33 33 33 33 22 33 33 33 33 33 33 33 33 33 33 33 33 33 33 33 33 33 33 33 33 33 33 33 33 33 33 33 28 28 28 28 
28 28 28 28 34 34 34 34 34 34 34 34 34 34 34 34 34 34 22 34 34 34 34 34 34 34 34 34 34 34 26 34 34 34 34 34 34 34 34 34 34 34 34 34 34 34 28 28 28 28 
28 28 28 28 33 33 33 33 33 33 33 33 33 33 33 33 33 33 22 33 33 33 33 33 33 33 33 33 33 33 22 33 33 33 33 33 33 33 33 33 33 33 33 33 33 33 28 28 28 28 
28 28 28 28 34 34 34 34 34 34 34 34 34 34 34 34 34 34 22 34 34 34 34 34 16 21 21 21 21 21 42 34 34 34 34 34 34 34 34 34 34 34 34 34 34 34 28 28 28 28 
28 28 28 28 33 33 33 33 33 33 33 33 33 33 33 33 33 33 22 33 33 33 33 33 22 80 83 82 80 81 22 33 33 33 33 33 33 33 33 33 33 33 33 33 33 33 28 28 28 28 
28 28 28 28 34 34 34 34 34 34 34 34 34 34 34 34 34 34 17 21 21 21 21 21 41 21 21 21 21 21 41 21 21 21 21 15 34 34 34 34 34 34 34 34 34 34 28 28 28 28 
28 28 28 28 33 33 33 33 33 33 33 33 33 33 33 33 33 33 109 110 111 112 109 110 111 109 112 109 110 109 112 111 109 110 111 22 33 33 33 33 33 33 33 33 33 33 28 28 28 28 
28 28 28 28 34 34 34 34 34 34 34 34 34 34 34 34 34 34 34 34 34 34 34 34 34 34 34 34 34 34 34 34 34 34 34 22 34 34 34 34 34 34 34 34 34 34 28 28 28 28 
28 28 28 28 33 33 33 33 33 33 33 33 33 33 33 33 33 33 33 33 33 33 33 33 33 33 33 33 33 33 33 33 33 33 33 23 33 33 33 33 33 33 33 33 33 33 28 28 28 28 
28 28 28 28 34 34 34 34 34 34 34 34 34 34 14 14 14 14 14 14 14 14 14 14 14 14 14 14 14 14 14 14 14 14 14 13 14 14 14 14 14 34 34 34 34 34 28 28 28 28 
28 28 28 28 33 33 33 33 33 33 33 33 33 33 38 13 13 13 13 13 13 13 13 13 13 13 13 13 13 13 13 13 13 13 13 13 13 13 13 13 39 33 33 33 33 33 28 28 28 28 
28 28 28 28 34 34 34 34 34 34 34 34 34 34 38 13 123 13 13 13 13 13 13 13 13 13 13 13 13 13 13 13 13 13 13 13 13 13 13 13 39 34 34 34 34 34 28 28 28 28 
28 28 28 28 33 33 33 33 33 33 33 33 33 33 38 13 13 13 13 13 13 13 13 13 13 13 13 13 13 13 13 13 13 13 13 13 13 13 13 13 39 33 33 33 33 33 28 28 28 28 
28 28 28 28 14 14 14 14 14 14 14 14 14 14 13 13 13 13 13 13 13 13 13 13 13 13 13 13 13 13 13 13 13 13 13 13 13 13 13 13 39 34 34 34 34 34 28 28 28 28 
28 28 28 28 10 11 11 11 11 11 11 11 13 13 13 13 13 13 13 13 13 13 13 13 13 13 13 13 13 13 13 13 13 13 13 13 13 13 13 13 39 33 33 33 33 33 28 28 28 28 
28 28 28 28 28 28 28 28 28 28 28 28 10 11 11 11 13 13 13 13 13 13 13 11 11 11 13 13 13 13 13 13 13 13 13 13 13 13 13 13 39 34 34 34 34 34 28 28 28 28 
28 28 28 28 28 28 28 28 28 28 28 28 28 28 28 28 10 11 11 11 11 11 12 28 28 28 10 11 12 28 10 11 11 13 13 13 13 13 13 13 39 33 33 33 33 33 28 28 28 28 
28 28 28 28 28 28 28 28 28 28 28 28 28 28 28 28 28 28 28 28 28 28 28 28 28 28 28 28 28 28 28 28 28 10 11 11 11 13 13 13 13 14 14 14 14 14 28 28 28 28 
28 28 28 28 28 28 28 28 28 28 28 28 28 28 28 28 28 28 28 28 28 28 28 28 28 28 28 28 28 28 28 28 28 28 28 28 28 10 11 11 11 11 11 11 11 12 28 28 28 28 
28 28 28 28 28 28 28 28 28 28 28 28 28 28 28 28 28 28 28 28 28 28 28 28 28 28 28 28 28 28 28 28 28 28 28 28 28 28 28 28 28 28 28 28 28 28 28 28 28 28 
28 28 28 28 28 28 28 28 28 28 28 28 28 28 28 28 28 28 28 28 28 28 28 28 28 28 28 28 28 28 28 28 28 28 28 28 28 28 28 28 28 28 28 28 28 28 28 28 28 28 
28 28 28 28 28 28 28 28 28 28 28 28 28 28 28 28 28 28 28 28 28 28 28 28 28 28 28 28 28 28 28 28 28 28 28 28 28 28 28 28 28 28 28 28 28 28 28 28 28 28 
28 28 28 28 28 28 28 28 28 28 28 28 28 28 28 28 28 28 28 28 28 28 28 28 28 28 28 28 28 28 28 28 28 28 28 28 28 28 28 28 28 28 28 28 28 28 28 28 28 28 
28 28 28 28 28 28 28 28 28 28 28 28 28 28 28 28 28 28 28 28 28 28 28 28 28 28 28 28 28 28 28 28 28 28 28 28 28 28 28 28 28 28 28 28 28 28 28 28 28 28 
28 28 28 28 28 28 28 28 28 28 28 28 28 28 28 28 28 28 28 28 28 28 28 28 28 28 28 28 28 28 28 28 28 28 28 28 28 28 28 28 28 28 28 28 28 28 28 28 28 28 
28 28 28 28 28 28 28 28 28 28 28 28 28 28 28 28 28 28 28 28 28 28 28 28 28 28 28 28 28 28 28 28 28 28 28 28 28 28 28 28 28 28 28 28 28 28 28 28 28 28 
28 28 28 28 28 28 28 28 28 28 28 28 28 28 28 28 28 28 28 28 28 28 28 28 28 28 28 28 28 28 28 28 28 28 28 28 28 28 28 28 28 28 28 28 28 28 28 28 28 28 
